[A, A, A, A, A, A, 1, A, A, A]
[A, 0, D, D, D, 0, 1, D, D, 1]
[A, D, A, 1, D, A, A, A, 0, A]
[A, 1, 1, D, D, 1, D, 1, D, D]
[1, D, A, A, D, 0, D, A, 1, D]
[A, D, D, 1, D, A, 0, 1, 0, D]
[A, 1, D, A, D, A, 1, 1, A, D]
[1, D, D, D, D, D, 0, 0, 1, D]
[A, D, 1, D, A, 1, D, 1, 1, D]
[A, 1, A, A, 1, D, D, D, D, D]